NO ./maps/textures/Purple_Wall.png
SO ./maps/textures/wall.png
WE ./maps/textures/Purple_Background.png
EA ./maps/textures/wall.png


F 88,88,88
C 40,40,40
        1111111111111111111111111
        1000000000110000000000001
        1011000001110000000000011
        10010000000000000W0000000
111111111011000001110000000000001
100000000011000001110111111111111
11110111111111010000000010001
11110111111111011101010000001
11000000110101011100000010001
10000000000000001100000010001
10000000000000001101010010001
1100000111010101111101111000111
11110111 1110101 101111010001
11111111 1111111 111111111111
