NO ./maps/textures/test.png
SO ./maps/textures/test.png

EA ./maps/textures/test.png


F 247, 27, 221

11111111111111111111111
1S010000000000001110001
10110110111111101011001
10100010010000101001101
10101110110110101001001
10100010011100111001111
10000111001110010000001
10010001100000000110001
11111111111111111111111
